NO ./texture/brick_gray.xpm
WE ./texture/brick_graymoss.xpm
SO ./texture/banner_redbrick.xpm
EA ./texture/brick_red.xpm

F 220,100,120
C 0,255,255

1111111
1001001
1000001
1000N01
1111111
