NO test.xpm
WE test.xpm
SO test.xpm
EA test.xpm

F 220,100,0
C 0,255,255

1111111
1001001
1000001
1000N01
1111111
