NO ./texture/banner_redbrick.xpm
WE ./texture/brick_red.xpm
SO ./texture/brick_gray.xpm
EA ./texture/brick_graymoss.xpm

F 220,100,0
C 0,255,255


111111111111111
100000000000101
100001000000101
111100000010101
100000000010101
1000000S1111101
100000000000001
100000000000001
111111000111101
100000000000001
111111111111111
